Level's Title
275
325
----f------
----f------
----f-ff---
----fff--f-
---ffff----
---ffff--f-
f--fffff--f
---fff-ff-f
----fff-f--
----ff-f---
-----f-f--f
------ffff-
-------fff-
+
-----------
-----------
-----------
-----------
-----------
-----------
-----------
-----------
-----------
-----------
-----------
-----------
-----------
