Went nuts with LD
2525
2075
-----------------------------------------------------------------------------------------------------
---------------------------------------------------------------------------------hh------------------
-------------------------------------------------------------------------------jjjhhh-h-h-h----------
-------------------------------------------------------------------------------j--hh--------h-hh-----
------------------------------------------------------------------------------j----h-----------------
-----------------------------------------------------------------------------j--------------hh-------
-----------------------------------------------------------------------------j-------------hh--------
-------------------------------------------------------------------------------------------h---------
-----------------------------------------------------------------------------------------------------
------------------------------------------------------------------------------j----h----jj-----------
-------------------------------------------------------------------------------jj---hhh---j----------
---------------------------------------------------------------------------------------h-------------
---------------------------------------------------------------------------------h---------------h--h
------------------------------------------------------------------------------------------------h--h-
---------------------------------------------------------------------------------hh-----------h------
--------------------------------------------------------222-2222-22----------------hh-h------h-----h-
------------------------------------------------------222rrrrrrrr----------------------h--h--------h-
-------------------------------------------------------rrrrrrr---------------------------hhhhh----hh-
-------------------------------------------------------rrrrrrr------------------------j--hhh--hh-----
--------------------------------------------------------rrrr---------------------hhh--jj-------------
------------------------------------------------00------------------------------h------jj------------
---------------------------------------------00--00jj-----------------------------------jj-----------
----ff------------------------------------000----jjjjj----fff--------------------h-------j-----------
-----f-----------ff-----------------------------jjjjjj-sffffff-------------------hhh-----------------
-----f------------f-------------------00---ff---jjjjj---fffffff---------------------hhh----hh--------
------------------f-------------------0--@-ff---jjjj----ffffff---------------------------------------
---------------f0--f----------0000---00--i--ff--jjj-------ffff---------------------------------------
---------------f0-ff----------fff--0-00-ii--ff-------------------------------------------------------
---------|-----f0---------&-----f-------ii--f-------ii------------------------hh------------h--------
--oo---ooo-----&f0000----ff-----f------ii------iii-ii--h----------------------h-h-hhh----jjj---------
-oo-------ooo---f---00--&f------f-----iii------iii-----hhhhh-------------------hh-------jj--hhh------
-o1----ff---o----f---00--f&----------iiii----------------hhhhhhh---------------hhhh---------jj-h-----
oo1------ff-fo---f----00ff-----------iii----c------ppp----hhhhhhhh-----------------hhhj--hh--j-h-----
o-111-11---------ff-----f------------ii-----c--ee--pgp-----hhhhhhhhb-----------------hjhh------------
-o---1-1-----------f----------f------ii--j--c--ee--pppp-----hhhhh--bbb----------------j--------------
--oo--o1--o--------ff---bbbb--f-----iii--j--c--e--------------hhh---------l--------------------------
----ooo1oo------|b--------b---ff----ii---j--c--e---------------hhh-------ll------------hhh-----------
---------|------bb--------b----f----ii---j--c--eeeeeeeee--------------bl-ll------b--------h----------
-------1-o-------b--------b&---------i---jj-c--eeeeeeeee-------------lbllll-----h-b-------h--j-------
------1--o------bbb-b-----b-------bbb----jj-c----eee----------b-----llbllll-----h-b--h---hh--------j-
----------o---bbb---b-b---b----j----b---jjj-c2---ee----------------lllbllll-----h-bb----hhh--j----j--
-1--11b---o--bb-------b--bb----jj---bb--jj--c222----f----bkk-------llblllll-----h--b-----h---j---jj--
-111--b---o----------bb-b------jjj-----jjj--ccc-----f--kkkkkkk----llllllll------h--b---------j---j---
-----bb-|----b-------bbbb--------jj----jjj--cc-22222-kkkkkkkkkk-bblllllll--------h-b---jj----jjj-----
-bb-----|-------------------------jjjjjjj---c--qqqq--kkkkbbbbb-b---lllll-----b---h-b---j----jj-------
--b----bb--------------------bbb------------c--qqqq---kkkkkkk------ll-------bb-b-------j-------------
--bb----------bbb----------bb-bb------------c---qqq----kkkkkk--------------b---b--h------------------
--b--ooooo---bb-------------bbb-----bb------c----qqq----------ooo--o-------b-bb---hh---j-------------
--b-----o----b-------bb----bbbb---------ll--c---------b-------oooooo------b-bb-----h------p----------
---b--o------b--------bb-bbbb-b-------lll---c333333333-|------oooooo------b-b------hh----pp----------
---b---o------b-----------------------lll---cccccccccccc----ooooooooo---------------hh--pp-----jj----
---b-4-oo-----b--------------------4l--l---|----------------oooooooo----------p-----------------j----
---b-44-oo-----b-------------------4ll-----pp--------------qoooooooo----------p----------------------
----bb4--o44----bb-----|---------4lllp-----ppp--k---jjjj---qoooqqqqqqq--------p-----------jj-jj------
-----b-44-4-4----bb-------k------4lllp---p-pppp-kjjjjjjjj-qooooooo-------------p------------j--------
-----b--------4--b----k---k-----4--l---p-p---pp-k-jjjjjjjqooooooooqqq----------p---------------------
------bb------bbbb---kk---k---44ll------ppp---ppk---jjjj-qoooooooqq--qq-------qqp--pp----------------
--------bbbbbb------kk--k----44ll------ppp-----pk--------q-ooooo-q-----------------p----p------------
--------------------kk-------------k---pppp-----k-------qq-o-oo--q-------------qpp-p-----p-p---p-----
--------------------k---k--------------p--------k-----------oo---------------------p-p------p-p-pp---
--o------------------------------hh---p-----hh-kk--e--------q----------------------------------------
---oooo----o--------k---k--------hh--------hhh-k--ee--------qq-qq------q-----------------------------
------oooooo--------k--k---------hh-----kk-h-h----ee---------qq----------qq--------------------------
---------------k----k--k--------hhh--e---khhh-----e------------------------qqq-----------------------
--------------kkk---kkkk--------hhh--ee---hh----eee----qq--------------------q----------q------------
----------------------k---------hhh--ee--hhh----eee---q----------------------qq--------q-------------
--------------------------------hhh--eee-hh----e-e---qq-----------------------q-------q--------------
--------------------------------hh---eee-h-----e-----qq-----------------------------q-q--------------
--------------------------------h-----ee--------------q---------------------q-------q----------------
--------------------------------------ee-f-----------------------------------qq----------------------
-----------------------------------------f------------------------------------q----------------------
-----------------------------------------f------------------------------------q-q--------------------
------------------------------------------f---ff---ff----------------------------q-qq----------------
------------------------------------------f----fffffff----------------------------q------------------
-----------------------------------------------------------------------------------------------------
------------------------------------------f----------------f-----------------------------------------
-------------------------------------------f----------------f----------------------------------------
--------------------------------------------f--------------ff----------------------------------------
--------------------------------------------f--------------------------------------------------------
---------------------------------------f-------------------------------------------------------------
-----------------------------------------f-f---------------------------------------------------------
--------------------------------------------ff--f----------------------------------------------------
----------------------------------------------ff-ff--------------------------------------------------
+
-----------------------------------------------------------------------------------ppp---pp----------
-----------------------------------------------------------------------------------p-ppp---pp--------
-----------------------------------------------------------------------------------------------------
--------------------------------------------------------------------------------------------p--------
--------------------------------------------------------------------------------------------p--------
------------------------------------------------------------------------------------------ppp--------
-----------------------------------------------------------------------------------------p-----------
------------------------------------------------------------------------------------ppppp------------
------------------------------------------------------------------------------------p----------------
-----------------------------------------------------------------------------------pp----------------
-----------------------------------------------------------------------------------p-----------------
-----------------------------------------------------------------------------------p-------------ppp-
------------------------------------------------------------------------------------p----p------ppp--
------------------------------------------------------------------------------------p----p------p--p-
-------------------------------------------------------------------------------------p---p-----p---p-
--------------------------------------------------------------------------------------p--p---pp----p-
--------------------------------------------------------------------------------------ppppp-p-pppppp-
--------------------------------------------------------------------------------------ppp--p------p--
--------------------------------------------------------------------------------------p----p---------
------------------------------------------------------------------------------------pp-----p---------
------------------------------------------------------------------------------------p-----pp---------
-----------------j-----------------------------------------------------------------pp-----p----------
-----------------jj---------------------------------------------------------------pppp-p-pp----------
------------------j---------j----------------------------------------------------pp-p-pppp-----------
-------------------j-------jjj-----------------------------------------------------pp----------------
-------------------jj---------jjjj------------------------------------------p-pp-p-------------------
--------------------j-----------jj------j----------------------------------p---ppppp------p----------
--------------------jj-----------------jj----------------------------------p------p-------p----------
---------------------------------------j-------ggg------------------------pp------p------ppp---------
--------------------------------------j-C---------------gggggggg---------pp-------gpp------p--p------
--------------------------------------j-----------------Cggggggggg-----ppp----------pp-ppp-pppp------
-------------------------------------jj------------g-----CCCCCCg-------p--------------pp------p------
----------------------pp-p-----------j------C--------------------g-g--p----------------g------p------
--------------------p-p--pp---0----------------CC------------------gg-----g-------------p------------
--------------------p------p--------1-------------------------------gg-ggg--------------ppp----p-----
-------------------p-------pp------------ppp--------------------------------------------p-pp--p------
--------------------p-------p------------p----------AAAA---------D--hhhhhh------g-------p--pp--------
-------------------pp--------p-----------p-------C--------------------D---------g-------p----pp------
------------------------------p---------pp-----ppp-ppp---------------D-----------------p-----pp------
---------yy-------------------p---------p-----p------p--------D-----D----------g-------p-------------
----------y--y----------------pp---------p-----------pp------------p----------g--------pp------------
-------------------------------p-pc-c-c--p-------------p-DDD-------p---------g----------p------------
------y--------------------------pppppppp-------------A-pp--------Dp---------g----------pppp---------
--------------------------------c------------------------ppp------p----------g--------------ppp------
--------y---------------------ccc---------------A----------pp-pppp----------g-----------------p------
--s----y------xxxx-----------cc-----------------A--------------------------gg------h----------p------
--s-------------------------cc-----------------------------------------------------h-----------------
--s-------------------ccc--cc-------------------------------------------------------h---------p------
--s----------------------ccc--------------------------------------------------------hh---------------
--ss--------------------------------------------A------------------------------------h-------pp------
---s-----------n----------------------------AAAAA------------------------------------hhp-------------
---s-----------nn-----ii---------z----------A--A----------------------------------------p-pppp-------
----s-----------nn---iiii--------z----------A--AAAAAAAAAA--------------------------------p-----------
-----------------nn--i--i-BB-----z----------A-A------------------------------------------------------
------qq---------t----iii-B------zz----------AA-----------------------------------------p------------
-------q---ttttttt-----i--B-------zzzzz------------------------------------------hhh----pp-----------
-------qqxxxqqqq---------B-------------z--zzzzz-------------------------------hhh-hh-----pp----------
--------ttqqx------------B--------------z-z---zz---------------------h--------h-----------pppppp-----
--------t---------------B----------------z-----z---------------------hh-h-h--hh-----------------pp---
------------------------B--------------------------B-----------------h-h---hhh-------------------pp--
-----------------------B--------------------------BB-------------------------------------------------
-----------------------B-------------------------BB-------------------h------------------------------
-----------------------B-------------------------B---------------------hhhh--------------------------
----------------------B--------------------------B-------------------------hhh-----------o-----------
---------------------B-----------------------BBBBB---------------------------hh------o-oo------------
---------------------B--------------------------------------------------------h----oooo--------------
---------------------B--------------------------------------------------------h----oo----------------
--------------------BB--------------------------------------------------------h---oo-----------------
-----------------------------------------------------------------------------h-----------------------
-----------------------------------------------------------------------------------------------------
-----------------------------------------------------------------------------hhh---------------------
-----------------------------------------------------------------------------------------------------
-----------------------------------------------------------------------------------------------------
-----------------------------------------------------------------------------------------------------
-----------------------------------------------------------------------------------------------------
-----------------------------------------------------------------------------------------------------
-----------------------------------------------------------------------------------------------------
-----------------------------------------------------------------------------------------------------
-----------------------------------------------------------------------------------------------------
-----------------------------------------------------------------------------------------------------
-----------------------------------------------------------------------------------------------------
-----------------------------------------------------------------------------------------------------
-----------------------------------------------------------------------------------------------------
