
250
300
------i---
----------
------i---
------ii--
--i----ii-
-iii---ii-
ii-IIiii--
---i--ii-i
i--I-I-Ii-
iiIII--I--
---I-ii---
--ii-i----
+
----------
----------
----------
----------
----------
----------
----------
----------
----------
----------
----------
----------
+
