
250
225
---iii----
--iIIiii--
--iI--i-i-
-iiIII-ii-
i-----i--i
ii----i--i
iii--i--i-
-i-ii-----
--iiiii---
+
----------
----------
----------
----------
----------
----------
----------
----------
----------
+
