5
Level's Title
--fffff---------
-ff----fff------
f---------fffff-
f-------------ff
f--------------f
f-----@--------f
-f-------****--f
-ff--3--****---f
--f-33-***----ff
--f-33**---%--f-
--f--**------ff-
--fffff--fffff--
---fffffffffff--
+
----------------
----------------
----------------
----------------
----------------
----------------
----------------
----------------
----------------
----------------
----------------
----------------
----------------
