#--------------------------#-------------#
#--------------------------#-------------#
#--------------------------#-------------#
#--------------------------#-------------#
#----#######---------------#-------------#
#--------------------------#-------------#
#--------------########----#-------------#
#---------------------#---##-------------#
#--###----------------##---#-------------#
#---##-----#----------#-?-##-------------#
#---#########-----##########-------------#
##--#--?#-----#-#----------#-------------#
#---#--##-----#------------#-------------#
#-#-#--##----##---#--------#-------------#
#---#-#####---#--#----?------------------#
#--##-#####---##---#-###-----------------#
#---#---####--#----------#---------------#
##--##--##---####--#------##-------------#
#-?-#--------####----------#-------------#
###################------###-------------#
