--------------------------------------------------------
#########################################################################################################################
#-------------------------------#########################################################################################
#-------------####--#####-------#########################################################################################
##----------#####------######---##########----------#####################################################################
#---------------#####--##------###########----------#####################################################################
#----------------------##------#########---##############################################################################
#--###----------##-----##------#--#####----##############################################################################
#--------------##-----##---#####--#####----##############################################################################
#-------------#########-------------------###############################################################################
##------------######------#####-----------###############################################################################
#--------------#####--------------------#################################################################################
#---######-------###-----#------#-------#################################################################################
##########--------##-----#-#----#-------#################################################################################
######-------#----####-###-----------#--#################################################################################
#-----------##-------#---#---#----------#################################################################################
#------#######-##----#---##-------------#################################################################################
#---#####-------#--#####-################################################################################################
#---#############--------################################################################################################
#########################################################################################################################
