-------------------------------------------------------------------------------------------
###########################################################################################
#------------------------------##-----#####-----------------------------------------------#
#-------------####--#####------##--------##------#################----##############------#
##----------#####------######--##--------#####-#-###############--------#########---------#
#---------------#####--##------##--------#######---------######-----------###------------##
#----------------------##------#########-------------------###------------##-----#--------#
#--###----------##-----##------#--#####--------------------##-----#####---------###-------#
#--------------##--#--##---#####--#####---------------##---##-----#####----------#--------#
#-------------#########----####-----------##########--##------------####------------------#
##------------######------#####-----------##########--##-----##------########-------------#
#--------------#####--------------------############---------##-------######--------------#
#---######-------###-----#--------------######---###---------##---------###---------------#
##########--------##-----#-#----#-------####---#-######---######--------------------------#
######-------#----####-###-----------#--###---#########---#######-------------------------#
#-----------##-------#---#---#------##--###---------####--##--####----------------####--###
#------#######-##----#---##-------------###---------------##--###----------------#####--###
#---#####-------#--#####-##################-#-----------------##------------------#########
#-#-#############--------##################################################################
###########################################################################################
