#--------------------------------------------------------------
---------------------------------------------------------------
---------------------------------------------------------------
---------------------------------------------------------------
---------------------------------------------------------------
--------------------------------------?------------------------
---------------------------------------------------------------
---------------------------------------------------------------
----------------------------------#----------------------------
----------------------------------#----------------------------
----------------------------------#----------------------------
----------------------------------#----------------------------
----------------------------------#----------------------------
----------------------------------#----------------------------
----------------------------------#----------------------------
----------------------------------#----------------------------
----------------------------------#----------------------------
----------------------------------#----------------------------
----------------------------------#----------------------------
----------------------------------#----------------------------
-----------------#----------------#----------------------------
-----------------#-----------#----#----------------------------
------#----------#-----------#----#----------------------------
-----##----------#-----------#---------------------------------
------#-------#--#----##??##-#---------------------------------
---#--#-------#--#----######-#---------------------------------
------#--##------#-----####--#---------------------------------
---------#------##-----------#---------------------------------
---##------------#-----------#---------------------------------
-----------#-----#----------##---------------------------------
----#----#-#-----------------#---------------------------------
-#--#----#--?----#-----------#---------------------------------
-#--#----#--#----#----------##---------------------------------
-#--#-#---------##-----------#---------------------------------
-#--#-#----------#-----------#---------------------------------
-#--#-#------#---#------#----#---------------------------------
-#--#-#---#------#------##---#---------------------------------
-#--#-#---#------#------#--------------------------------------
-#--#-##--#------#----#-#---###--------------------------------
-#--#-#---#-----------#-#---###--------------------------------
-#--#?----#-------##--------####---#---------------------------
-#--###---#---#------#--#----------#---------------------------
-#--#-----#---#-#-------#----------#---------------------------
-#--#-----#---#-----#####----------#---------------------------
-#--#----##-------#---###----------#---------------------------
-#--#-----#---#-#-------#----------#---------------------------
-#--------#---#-#-##-#--#----------#---------------------------
-#--------#---#-#----#-##----------#---------------------------
-#--------#---#--------------------#---------------------------
-#----------------####--#----------#---------------------------
-------##-----##----#---#--------------------------------------
--------------#---#---###--------------------------------------
--------------#------------------------------------------------
--------------##-#--##--#----#---------------------------------
-----------------------##----#---------------------------------
--------------#-#-#-##--#----#---------------------------------
--------------#----------#---#---------------------------------
--------------#-###-----#--------------------------------------
---------------------------------------------------------------
--------------------------------------------------------------#
