------------#---------------
----------#-----------------
--------#---#--#----#-------
----------------------------
-----------#-#-#-#----------
-------#---------------#----
----------#-#-#-#---#-------
--------#-------------------
-------#----#--#------------
----------#-------#----#----
----#-----#--#--#-----------
--------#----------##-------
-----#-----#---#------------
--------#-#--------#----#---
-----#--------#--------#----
----------------------#-----
-------#####-#--------------
--------------#-#-###-------
------#---------------------
############################
