#-----------#--------------#
#---------#----------------#
#-------#---#--#----#------#
#-#------------------------#-
#----#---#---#-#-#-#-------#--
#------#---------------#---#
#-#--##------#-#-#-#---#---#---
#-------#------------------#
#--#----#----#--#----------#-
#---------#-------#----#---#
#---#-----#--#--#----------#
#-#------#----------##---#-#--
#----#-----#---#-----------#
#-------#-#--------#----#--#
#----#--#------#--------#--#-
##---------#----#--#-------#---
#--#-----#----#----#---#---#
#---------------#--------#-#
#-#-#----#-#-------#-------#
#------##-------#---#----#-#-
##-#----#-#---#-----#--#---#
#------#---------#---------#-
#--#-----#----#------------#-
##----------#-#---#----#---#
##--#--#--#----------------#
#------------##---#---##---#
#-#------#-----------------#
##-----------#----#---#----#
###########################
