#--------------------------#
#---------#----------------#
#-------#---#--#----#------#
#-#------------------------#-
#----#---#---#-#-#-#-------#--
#------#--#------------#---#
#-#--##---#--#-#-#-#---#---#---
#-------#------------------#
#--#----##---#--#---##----#-
#---------#-------#----#---#
#---#-----#-#--#----------#
#-#------#----------##---#-#--
#----#-----#---#-----------#
#-------#-#--------#----#--#
#----#--#-----#------#-#--#-
##---------#----#--#-------#---
#--#-----#----#----#---#---#
#---------------#--------#-#
#-#-#----#-#--#----#-------#
#------##-------#---#----#-#-
##-#----#-#---#-----#--#---#
#------#---------#---------#-
#--#-----#----#-----##-----#-
##------------#---#----#---#
##--#--#--#----------------#
#------------##---#---##---#
#-#------#-----------------#
##-----------#----#---#----#
############-###############
#------#-#-###-#---#-------#
#------#-#-#---#---#-------#
#------###-###-#---#-------#
#------#-#-#---#---#-------#
#------#-#-###-###-###-----#
############################
