#################################################
#---------#------#------#------#----------------#
#-------#---#------#------#------#-------#------#
#-#---------------------------------------------#
#----#---#-----##-----##-----##-----#####-------#
#------#-----###---###-###------###---######---##
#-#--##------#-#----#-#-----#-#---#-#----#-#-#-##
#----------#------#------#--#-###------#-------##
#-------##---#--#---#--#-------#--#--#---#--#---#-
#------####------#------#----#--------#-------#-#
#--------------#------#-------------#------#-----
#-###------------------------#-#-----------------
#----###-------#------####----------#------#----#
#-------#-#------#--------#-#--#------#---------#
#----#--#-##-###-##-####--#-##-##-###-##-###---##-
##---------#----#-#----------##-#----#-#----#--##---
#--#-----#----#------#-----#-------#------#-----#
#---------------#-------------#------#------#---#
#-#-#----#-#--#---#--#-----#-#--#--#---#--#-----#
#------##-------#------#------#------#--##----#-#-
##-#----#-#---#--#---#--#---#--#---#-----#--#---#
#------#---------------###-------------------#--#-
#--#-----#----#------#----#-#------#------#-----#
##-#----#-###----#---#--#---#-#--#-##-#---#--#--#
#------#-----#-#--------------------#------------
#--#-----##--#-##----#------#-----#-------#------
##--------------#----#------#-------------#-----#
##--#--#------#--#------#---------#-#-#------#---
#-------------------##-----##-----##-----##----##
#-#------#----#-#--------------------------------
##-----------#------#------#------#----#---#----#
########-----####---####---####---###############
#------#----##-#---##-#---##-#---##-#---#-------#
#------#-#-----#------#------#------#---#-------#
#------###--##-#---##-#---##-#---##-#---#-------#
#------#-#-#---#--#---#--#---#--#---#---#-------#
#------#-#-#-#-##-#-#-##-#-#-##-#-#-###-###-----#
################################################
