############################
#---------#----------------#
#-------#---#-------#------#
#-#------------------------#-
#----#---#-----#####-------#--
#------#-----#######---#---#
#-#--##------#-#-#-#---##--#---
#----------#-------##------#
#-------##---#--#---------##-
#------####-------#---##---#
#--------------#----------#
#-###---------------##---#-#--
#----###-------#-----------#
#-------#-#-------------#--#
#----#--#-##-###---#--#-#--#-
##---------#----#--#-------#---
#--#-----#----#------###---#
#---------------#--------#-#
#-#-#----#-#--#------------#
#------##-------#--##----#-#-
##-#----#-#---#-----#--#---#
#------#---------#---------#-
#--#-----#----#-----##-----#-
##------------#---#----#---#
##--#--#--#----------------#
#------------##----#--##---#
#-#------#-----------------#
#----###-------#-----------#
#-------#-#-------------#--#
#----#--#-##-###---#--#-#--#-
##---------#----#--#-------#---
#--#-----#----#------###---#
#---------------#--------#-#
#-#-#----#-#--#------------#
#------##-------#--##----#-#-
##-#----#-#---#-----#--#---#
#------#---------#---------#-
#--#-----#----#-----##-----#-
##------------#---#----#---#
##--#--#--#----------------#
#------------##----#--##---#
#-#------#-----------------#
#----###-------#-----------#
#-------#-#-------------#--#
#----#--#-##-###---#--#-#--#-
##---------#----#--#-------#---
#--#-----#----#------###---#
#---------------#--------#-#
#-#-#----#-#--#------------#
#------##-------#--##----#-#-
##-#----#-#---#-----#--#---#
#------#---------#---------#-
#--#-----#----#-----##-----#-
##------------#---#----#---#
##--#--#--#----------------#
#------------##----#--##---#
#-#------#-----------------#
##-----------#----#---#----#
############################
#------#-#-###-#---#-------#
#------#-#-#---#---#-------#
#------###-###-#---#-------#
#------#-#-#---#---#-------#
#------#-#-#-#-###-###-----#
###########################
